##############
##############
#------------#
#---######---#
#---######---#
##---####---##
###--------###
####------####
##############
##############
##############
#######B######
##############
##############
##############
