##############
##############
##-##-##-##-##
###--#--#--###
##-##-##-##-##
-############-
##############
#######B######
##############
##############
##############
##############
##############
##############