##############
##############
#------------#
#--#########-#
#-##-#######-#
#-####-#####-#
#-######-###-#
#-########-#-#
#-#########--#
#------------#
##############
##############
#######B######
##############
##############