##############
##############
##---####---##
#-##------##-#
#-###----###-#
#-####--####-#
#-####--####-#
#-##########-#
#------------#
##############
##############
##############
#######B######
##############
##############