##############
##############
#####----#####
#####----#####
#####----#####
#####----#####
#####----#####
#####----#####
#####----#####
##############
##############
#######B######
##############
##############
##############